1111111111111111111111111111111111111
1C000C0000000000000000000000000000001
1001111100000011111110000000000000001
1000000000000000000000100C00000000001
10000000000000C0000000000000100000001
10000000000000000000000000010100C0001
1000000000100000000000000010000000001
1000000000000111000010000000000000001
100C0000000000C0000000000000000000001
1000000000000000000111000000000000001
1000000001000000000000110000001100001
100000000000C000000000000000000000001
1000000000000000000000C00000000001011
1000000000000000001111000000000001E11
1000000000000000000000000000000001011
1000000111100000000000000000000001C11
100000000000000000000000000111C000001
1C0000C0000001111000P0000000010000001
100000100000000000000000000111C000001
1111111111111111111111111111111111111
